Korean Pork Chops: boneless pork chops, soy sauce, honey, garlic, sesame oil, fresh ginger, sweet chili sauce, olive oil
Easy Korean Sticky Chicken: chicken breasts, honey, gochujang, soy sauce, ginger, garlic cloves, vegetable oil, sesame seeds, scallions
Korean Ground Turkey Rice Bowls: medium grain white rice, water, zucchini, cremini mushrooms, garlic cloves, gochujang, applesauce, toasted sesame oil, water, ground turkey, vegetable oil, salt, vegetable oil, salted butter, salt, black sesame seeds, microgreens, toasted sesame oil
Korean Bulgogi: rib eye steak, soy sauce, sesame oil, sugar, garlic, green onion, onion
Korean Style Pork Chops: boneless pork chops, olive oil, soy sauce, honey, garlic cloves, sesame oil, ginger, Sriracha sauce, ground black pepper
Korean Ground Turkey & Rice Bowls: ground turkey, rice, garlic, honey, soy sauce, sesame oil, ground ginger, crushed red pepper flakes, ground black pepper, green onion, sesame seeds
Spicy Sticky Korean Chicken: gochujang, soy sauce, rice wine vinegar, honey, sesame oil, fresh ginger, garlic, chicken, vegetable, green onions, toasted sesame seeds
Ground Turkey Recipe (Korean-Style): soy sauce, cornstarch, brown sugar, red chili flakes, sesame oil, garlic, fresh ginger, ground turkey, chives, sesame seeds
Korean Pancakes: all-purpose flour, salt, pepper, eggs, water, mushrooms, carrots, zucchini, green onion, rice wine vinegar, soy sauce, sugar, toasted sesame seeds, jalapeno, canola oil
Korean Ground Beef Bowl: low sodium soy sauce, garlic, sesame oil, brown sugar, rice vinegar, ginger root, chili garlic sauce, ground beef, green onions, eggs, butter, cooked rice, sesame seeds
Korean Cucumber Salad: kirby cucumbers, scallion, white distilled vinegar, soy sauce, garlic clove, salt, sugar, red chili pepper flakes, sesame seeds
Spicy Korean Pork Skewers: boneless country style pork ribs, garlic chili sauce, soy sauce, fresh ginger root, sake, sesame oil, brown sugar
Korean BBQ Pork Chop: shallot, garlic, brown sugar, fish sauce, rice vinegar, Sriracha, lime juice, freshly ground black pepper, bone-in pork chops
Korean Corn Cheese: sweet corn, mayonnaise, sugar, salt, black pepper, onion, red chili, unsalted butter, mozzarella cheese
Korean Vegetarian Beef: veggie ground round, brown sugar, light soy sauce, olive oil, sesame oil, onion, garlic, fresh ginger, red chili flakes, ground black pepper, sesame seeds, basmati rice, green onions
Korean beef Bulgogi: flank steak, yellow onion, soy sauce, white sugar, garlic, sesame oil, sesame seeds, freshly ground black pepper, green onions, cooked white rice, fresh ginger
Korean Beef Bowls: honey, dark brown sugar, sesame oil, fresh lime juice, soy sauce, water, ground beef, green onions, minced fresh garlic, fresh ginger, green onions, unsalted peanuts, sesame seeds, sriracha, brown rice, brown rice, cauliflower, veggies, carrots
Korean-Style Popcorn Cauliflower: gochujang, soy sauce, honey, water, oil, eggs, all purpose flour, kosher salt, freshly ground black pepper, cayenne pepper, cauliflower, sesame seeds, minced chives
Korean Glazed Chicken Drumsticks: sesame oil, cornstarch, soy sauce, rice vinegar, brown sugar, garlic, ground ginger, sesame seeds, crushed red pepper flakes, chicken drumsticks, sliced green onions, sesame seeds
Korean Short Ribs: beef short ribs, soy sauce, brown sugar, sesame oil, Sriracha, onion, garlic, sauce
Korean Noodles: mung beans, scallions, kimchi, wide rice noodles, vegan butter, gochujang, fresh vegetables, spice
Sweet Korean Pork Ribs: rice wine, black vinegar, soy sauce, dark soy sauce, brown sugar, gochujang, sesame oil, sesame seeds, spring onions, minced garlic, pork ribs, sweet potato starch, honey, chinese five-spice powder, black pepper, garlic salt
Korean BBQ Sauce: brown sugar, soy sauce, rice vinegar, sambal oelek, sesame oil, black pepper, fresh grated ginger, garlic, cornstarch, water
Bulgogi – Korean Beef BBQ (불고기): beef, soy sauce, sugar, honey, sugar, cooking wine, sesame oil, minced garlic, ground black pepper, toasted sesame seeds, green onion
Homemade Korean Kimchi: napa cabbage, scallions, garlic, fresh ginger, jalapenos, red chili pepper, onion, sea salt, raw honey
Spicy Korean Chicken: boneless chicken thighs, medium white onion, minced garlic, minced ginger, gochugaru, sesame seed oil, brown sugar, rice wine vinegar, soy sauce
Korean Beef Bulgogi: skirt steak, marinade, peanut, green onions
Korean Steak Kabobs: flank steak, sesame seeds, garlic cloves, soy sauce, root beer, brown sugar, toasted sesame oil, salt, pepper, bacon, flour, sesame seeds, chopped parsley
Sweet Korean Chicken Wings: chicken wings, neutral oil, kosher salt, black pepper, sauce, brown sugar, minced ginger, soy sauce, rice wine vinegar, sesame oil, scallions
Korean Tofu Soup: kimchi, liquid, gochujang, green onion, silken tofu, mushrooms, eggs, fish sauce, soy sauce, sesame oil, sesame seeds
Pajeon (Korean Scallion Pancake): all-purpose flour, large egg, water, kimchi juice, scallion, salt, oil, soy sauce, rice vinegar, red chili flakes, sugar, garlic
Korean Beef Bowl: ground beef, onion, garlic, spring onions, red chilli, salt, black pepper, toasted sesame seeds, vegetable oil
Korean Cream Cheese Garlic Bread: warm water, active dry yeast, all-purpose flour, granulated sugar, kosher salt, large egg, cream cheese, granulated sugar, unsalted butter, whole milk, granulated sugar, garlic, parsley flakes, large egg, kosher salt
Korean Short Rib Tacos: beef short ribs, soy sauce, brown sugar, mirin, sesame oil, garlic, scallions, ginger, napa cabbage, daikon, bean sprouts, scallions, cilantro, lime, soy sauce, mirin, Sriracha sauce, extra virgin olive oil, corn tortillas, Sriracha sauce
Hoddeok (Hotteok) – Sweet Korean Pancake: all-purpose flour, lukewarm water, dry yeast, salt, vegetable oil, white sugar, brown sugar, chopped walnuts, cinnamon powder
Korean Barbecue Chicken Legs: chicken drumsticks, soy sauce, honey, rice vinegar, brown sugar, garlic, corn starch, sesame oil, ginger, sesame seeds, red pepper flakes, green onions, sesame seeds, olive oil, sesame oil, Sriracha
Galbi Korean Marinated Short Ribs: flanken-cut short ribs, soy sauce, brown sugar, toasted sesame oil, garlic, apple pear, nonstick cooking spray, scallions, toasted sesame seeds
Korean Bok Choy: bok choy, chopped garlic, gochujang, soy sauce, sesame oil, sugar, cornstarch, water
Korean Chicken Skewers: chicken breasts, minced garlic, 3 Tablespoons grated ginger, onions, soy sauce, sesame oil, brown sugar, green onions, salt, pepper
Korean Spicy Noodle Salad: noodles, egg, cucumber, carrot, bean sprouts, roasted sesame seeds, coriander, pear, sauce, sesame oil, seaweed
Spicy Korean-style Meatball Bowl: lean ground pork, asian pear, panko bread crumbs, scallions, garlic, gochujang, soy sauce, large egg, rice vinegar, black pepper, kosher salt, canola oil, rice noodles, cooked brown rice, baby bok choy, sesame seed, green onions, fresno chiles, Sriracha chili sauce, blackberry jam, rice vinegar, soy sauce, kosher salt
Korean-Style Short Ribs: sake, reduced sodium soy sauce, vietnamese fish sauce, honey, peanut oil, sesame oil, large garlic cloves, fresh ginger, green onions, water, flanken, beef short ribs, freshly ground pepper, Chinese five-spice
Korean BBQ Chicken: chicken pieces, bbq sauce, reduced sodium soy sauce, light brown sugar, water, Soju, gochujang, honey, rice wine vinegar, minced garlic, fresh ginger root, scallions, pear, black pepper, chili pepper, starch
Korean-Style Pork Chops: soy sauce, light brown sugar, garlic chili sauce, sesame oil, ground ginger, vegetable oil, boneless pork chops, salt, pepper, green onions
Korean BBQ Marinade: soy sauce, pear juice, toasted sesame oil, garlic, scallions, fresh ginger, brown sugar, seeds, freshly ground black pepper
Sweet Korean Lentils: water, soy sauce, brown sugar, garlic, ginger, sesame oil, crushed red pepper flakes, oil, yellow onion, red lentils, green onions, sesame seeds, cooked rice
Sheet-Pan Korean Pork Chops: bone-in pork chops, honey, hot-and-sweet gochujang sauce, fresh ginger, seasoned rice vinegar, Asian toasted sesame oil, nonstick cooking spray, broccolini spears, rainbow carrots, canola oil, toasted sesame seeds, sliced green onions, cooked rice
Bomb Korean Sushi: gochujang, fresh shiitake mushrooms, soy sauce, eggplant, sesame oil, agave, garlic, carrot, daikon radish, spinach, cucumber
Korean Beef Tacos: brown sugar, reduced sodium soy sauce, sesame oil, crushed red pepper flakes, ground ginger, vegetable oil, garlic, ground beef, sesame oil, kimchi, sugar, mayonnaise, Sriracha, lime juice, flour tortillas, diced red onion, cilantro leaves, sesame seeds
Korean Cheese Katsu: mozzarella cheese, boneless pork loin, avocado oil, panko bread crumbs, eggs, all-purpose flour, salt, pepper
Korean Street Cheese Corn Dogs: all purpose flour, baking powder, salt, sugar, egg, cold milk, cheese sticks, panko bread crumbs, frying oil, sugar, ketchup, honey mustard
Korean Beef Stir Fry: sirloin, baking soda, cornstarch, gochujang, soy sauce, oyster sauce, beef broth, soy sauce, dark soy sauce, mirin, vegetable oil, large onion, garlic, medium carrot, green onions, sesame oil, sesame seeds
Korean Marinade: reduced sodium soy sauce, sesame oil, rice vinegar, dark brown sugar, garlic, gingerroot, green onions, Sriracha, sake
Korean BBQ Burrito: top sirloin, pears, ginger, garlic, soy sauce, brown sugar, sesame oil, cooked rice, cilantro, basil, green onions, mint, kimchi, mayo, sauce, large flour tortillas
Mandu Recipe (Korean Dumplings): dumpling wrappers, kimchi, tofu, mung bean sprouts, onion, scallions, ground pork, minced garlic, ginger, sesame oil, soy sauce, egg, salt, pepper, soy sauce, vinegar, water, sugar, black pepper, red pepper flakes
Bulgogi (Korean BBQ Beef): water, soy sauce, white sugar, sesame oil, garlic powder, onion powder, red pepper flakes, rib eye steaks, vegetable oil, scallions, black sesame seeds, steamed white rice, kimchi
Korean Potato Banchan Gamja Jorim: cooking oil, baby potatoes, water, soy sauce, maple syrup, sesame seeds
Spicy Korean Pork Bulgogi: pork belly, green onions, garlic, ginger, medium onion, gochujang, soy sauce, honey, sesame oil, cooking wine, water, gochugaru
Korean Bulgogi Sauce: pear, coconut aminos, medjool date, toasted sesame oil, garlic, ginger, chili paste
Slow Cooker Korean Beef: beef broth, reduced sodium soy sauce, packed brown sugar, garlic, sesame oil, rice wine vinegar, freshly grated ginger, Sriracha sauce, onion powder, ground white pepper, boneless beef chuck roast, cornstarch, water, green onions, sesame seeds
Slow Cooker Korean Short Ribs: short ribs, soy sauce, water, rice vinegar, dark brown sugar, ground pepper, sesame oil, minced garlic, ginger, medium onion
Korean Spicy Pork (제육볶음 Jeyuk bokkeum): garlic, red chili, green onion, sweet onion, soy sauce, Korean red pepper paste, mirin, red pepper flakes, sesame seeds, sesame oil, salt, pork butt, oyster mushrooms
Korean Bulgogi Marinade: light soy sauce, mirin, sesame oil, brown sugar, pear, green onions, ginger, garlic, chili powder, salt, pepper
Jap Chae / Chap Chae - Korean Glass Noodles: glass noodles, sesame oil, olive oil, onions, carrots, garlic, green onions, crimini mushrooms, spinach, soy sauce, sugar, sesame seeds
Korean Black Bean Noodles: bean paste, minced garlic, sesame oil, brown sugar, lukewarm water, potatoes, carrots, zucchini, onions, pork loin, cornstarch, cold water, udon
Korean Tacos: napa cabbages, water, kosher salt, gochugaru, sugar, fish sauce, minced garlic, ginger, scallions, carrots, garlic, yellow onion, pear, soy sauce, sesame oil, brown sugar, gochujang, sirloin, vegetable oil, corn tortillas, sour cream, sriracha sauce, toasted sesame seeds, cilantro, limes
Korean Spicy Rice Cakes: kelp, water, miso paste, soy sauce, gochujang, gochugaru, granulated sugar, Korean rice cakes, scallions
Korean Beef Lettuce Wraps: lettuce, lean ground beef, brown sugar, soy sauce, sesame oil, garlic, ground ginger, red pepper flakes, green onions, rice wine vinegar, sesame seeds
Korean Grilled Chicken Breasts: boneless skinless chicken breasts, low sodium soy sauce, unsweetened applesauce, yellow onion, sesame oil, ginger, light brown sugar, garlic cloves, red pepper flakes, sesame seeds, scallions
Sweet Korean Paleo Chicken Thighs: honey, gochujang, coco, sesame oil, minced ginger, garlic cloves, boneless, skinless chicken thighs, sesame seeds, sliced green onions, cauliflower, sea salt
Easy Korean Meatballs: ground beef, green onions, garlic cloves, egg, panko breadcrumbs, Korean chili paste, minced fresh ginger, low sodium soy sauce, salt, rice vinegar, brown sugar, low sodium soy sauce, gochujang
Ultimate Korean Fried Chicken: rice vinegar, water, superfine sugar, kosher salt, daikon radish, cornstarch, kosher salt, baking powder, black pepper, chicken drumsticks, oil, cornstarch, matzo meal, all purpose flour, Korean chile flakes, kosher salt, garlic, onion, baking powder, water, vodka, korean chile paste, korean chile paste, ketchup, dark brown sugar, soy sauce, roasted sesame oil, ginger, garlic
Korean Scallion Pancake: all-purpose flour, cold water, salt, large egg, scallions, soy sauce, red pepper
Korean Beef: sesame oil, minced garlic, lean ground beef, brown sugar, soy sauce, minced ginger, red peppers, salt, pepper, green onions, salt, pepper, sesame oil
Korean Popcorn Chicken: chicken, rice wine vinegar, cornstarch, kosher salt, black pepper, canola oil, sesame seeds, toasted, scallions, sauce, garlic clove, minced ginger, gochujang, soy sauce, rice wine vinegar, light brown sugar, honey, toasted sesame oil
Korean Country Spare Ribs: spare ribs, brown sugar, soy sauce, water, mirin, small onion, garlic, toasted sesame oil, freshly ground black pepper, chives
Grilled Korean Flank Steak: soy sauce, chili sauce, ginger paste, garlic paste, brown sugar, sesame oil, flank steak, sesame seeds, green onions, soy sauce
Korean Steak: soy sauce, coca-cola, toasted sesame oil, hoisin sauce, garlic, scallions, rib eye steaks
﻿Korean Vegetable Pancakes: all purpose flour, ice cold water, egg, salt, vegetable oil, medium potatoes, carrot, green pepper, red pepper, scallions, soy sauce, water, sugar, rice vinegar, sesame oil, roasted sesame seeds, scallion, crushed red pepper
Korean Beef Short Ribs: onion, garlic cloves, unsweetened pineapple juice, pineapple, soy sauce, honey, toasted sesame oil, white wine, short ribs, sesame seeds, green onions, romaine lettuce leaves, dipping sauce, soy sauce, rice vinegar, sugar, fresh ginger
Korean Barbecue Sauce: brown sugar, tamari, rice wine vinegar, gochujang, sesame oil, fresh minced ginger, minced garlic, honey, fresh ground black pepper, cornstarch, water
Easy Korean Kimchi: napa cabbage, sea salt, fish sauce, gochugaru, garlic cloves, fresh ginger, white sugar, pear, daikon, spring onions, batons
Korean Ground Beef: lean ground beef, roasted red peppers, gochujang, sesame oil, lite soy sauce, brown sugar, crushed red pepper
Bibimbap (Korean Mixed Rice): beef, garlic cloves, ginger, green onion, light soy sauce, sugar, sesame oil, salt, black pepper, carrot, zucchini squash, lettuce, bean sprouts, shiitake mushrooms, gochujang, sugar, sesame oil, rice vinegar, light soy sauce, cooked rice, eggs, green onion, sesame seeds, seaweed
15-Minute Low-Carb Korean Beef Bowl: coconut oil, ginger, garlic, red chilli, celery stick, beef mince, tamari soy sauce, fish sauce, coconut sugar, sesame oil, tomato paste, lime, sesame seeds, spring onions, cauliflower, coconut oil, salt
Korean Seafood Ramen: cooking oil, garlic, green onions, ramen noodles, mixed seafood, eggs
Quick Korean Spicy Slaw: napa cabbage, red cabbage, green onions, large carrot, red bell pepper, seasoned rice vinegar, gochujang, canola oil, garlic, fresh ginger, soy sauce, sesame seeds
Classic Korean Tofu: tofu, salt, black pepper, soy sauce, gochugaru, spring onion, sesame seeds, sesame oil
Instant Pot Korean Beef: beef broth, reduced sodium soy sauce, brown sugar, garlic, sesame oil, rice wine vinegar, ginger, Sriracha, onion powder, white pepper, boneless beef chuck roast, cornstarch, sesame seeds, green onions
Spicy Korean Cauliflower Wings: cauliflower, coconut oil, gochujang, honey, soy sauce, rice vinegar
Korean Kimchi Scallion Pancakes: flour, ice cold water, salt, large eggs, vegetable oil, scallions, cabbage, cremini mushrooms, low sodium soy sauce, roasted sesame seeds
Sticky Korean Chicken: chicken thighs, oil, roasted sesame seeds, scallion, gochujang, soy sauce, light brown sugar, garlic, ginger, rice vinegar, paprika
CrockPot Korean Ribs: beef short ribs, soy sauce, brown sugar, jalapeno peppers, water
Air Fryer Korean Pork Lettuce Wraps: pork tenderloin, Gochujang sauce, reduced sodium soy sauce, scallions, cooked brown rice, butter lettuce leaves, English cucumber, shredded carrots, sesame seeds, scallions, Gochujang sauce
Best Korean BBQ Tacos: soy sauce, dark brown sugar, minced garlic, rice wine vinegar, gochujang, ground ginger, Asian toasted sesame oil, ground black pepper, cornstarch, water, steak, broccoli slaw, green onions, taco shells, ranch dressing
Korean Cucumber Salad (Oi Muchim 오이무침): cucumber, soy sauce, rice vinegar, sugar, red chili powder, sesame seeds, green onions
Korean Beef Rice Bowl: rice, beef, soy sauce, sesame oil, fresh ginger, garlic clove, brown sugar, cooking oil, onion, carrot, zucchini, spinach leaves, roasted sesame seeds
Oi Muchim (Spicy Korean Cucumber Salad): rice vinegar, gochugaru, toasted sesame oil, toasted sesame seeds, salt, sugar, scallion, kirby cucumbers
Dakdoritang (Korean spicy chicken stew): chicken parts, potatoes, carrots, onion, garlic cloves, ginger, scallions, red chili pepper flakes, sugar, soy sauce, rice wine, honey, red chili pepper, pepper, sesame oil, sesame seeds
Gyeran Mari (Korean Rolled Omelette): large eggs, scallion, small carrot, salt, vegetable oil
Korean Cheese Corn: corn, mayonnaise, Sriracha, sugar, kosher salt, freshly ground black pepper, mozzarella, green onions
Korean Kalbi Beef: asian pear, kiwi, soy sauce, brown sugar, garlic, sesame oil, freshly ground black pepper, beef short ribs
Cheater Korean Beef: sesame oil, lean ground beef, garlic, brown sugar, low sodium soy sauce, minced ginger, chili garlic sauce, salt, pepper, scallions, toasted sesame seeds, cooked white rice
Versatile Korean Spicy Sauce: garlic, chilli paste, sugar, warm water
Korean Spicy Noodles: flank steak, sesame oil, potato starch noodles, yellow onion, shiitake mushrooms, carrots, red bell pepper, baby spinach, low sodium soy sauce, brown sugar, rice wine, gochujang, pepper, garlic cloves, ground ginger, cornstarch, beef bouillon, green onions, sesame seed
15-Minute Korean Beef and Quinoa Bowl: quinoa, vegetable oil, ground ginger, garlic, lean ground beef, brown sugar, low sodium soy sauce, sesame oil, crushed red pepper flakes, salt, pepper, green onions
Korean Ground Beef over Rice: ground beef, garlic cloves, soy sauce, brown sugar, sesame oil, fresh ginger, red pepper flakes, cooked rice, roasted sesame seeds, green onions
Bulgogi Korean BBQ Short Ribs: beef short ribs, green onions, soy sauce, brown sugar, apple sauce, rice wine vinegar, ginger, garlic, toasted sesame seeds, sesame oil
Easy Korean Ground Beef and Broccoli: lean ground beef, garlic cloves, soy sauce, orange juice, brown sugar, toasted sesame oil, cornstarch, cooked rice, broccoli, sliced green onions, sesame seeds
Korean-style Marinated Grilled Chicken: chicken legs, chicken thighs, soy sauce, sugar, sesame oil, water, garlic cloves, green onion stalks, ginger, salt, pepper
Korean Ground Beef and Rice Bowls: lean ground beef, garlic cloves, brown sugar, reduced sodium soy sauce, sesame oil, ground ginger, crushed red pepper flakes, pepper, brown rice, sliced green onions, sesame seeds
Korean Kimchi Stew with Tofu: safflower oil, brown rice, white onion, zucchini, carrots, korean chile paste, low sodium vegetable broth, shiitake mushrooms, silken tofu, kimchi, large eggs, chopped fresh chives, hot sauce
Dak Bulgogi (Korean Chicken BBQ): boneless chicken thigh, soy sauce, lemon juice, brown sugar, honey, rice wine, minced garlic, ginger, sesame oil, black pepper, sesame seeds
Easy Korean Beef and Rice {Ground Beef Recipe}: lean ground beef, garlic, brown sugar, soy sauce, ground ginger, crushed red pepper flakes, cooked white rice, green onions
Korean Bulgogi Stew (Bulgogi Jungol): bulgogi, onion, scallions, carrots, bean sprouts, vegetables, water, mushrooms, tofu, salt
Korean Bean Sprout Soup (Kongnamul Gook): soybean sprouts, water, garlic, soy sauce, sesame oil, salt, scallion, red pepper
Korean Bibimbap Recipe - Paleo and Low-Carb: cucumber, daikon radishes, soy sauce, rice vinegar, gochujang, sesame oil, roasted sesame seeds, lean ground pork, scallions, minced garlic, fresh ginger, salt, fresh spinach, large eggs, cooking oil
Easy Korean Beef Bulgogi: top sirloin, bulgogi sauce, vegetable oil, lettuce, rice, green onion, sesame seeds, red chili, radish, doenjang, gochujang, sesame oil, mirin, green onion, garlic, apple juice
Korean Grilled Tuna: tuna fillets, salt, black pepper, soy sauce, mirin, ginger, brown sugar, gochujang, sesame seeds
Korean Spicy Cucumber Salad “Banchan”: cucumbers, kosher salt, red pepper flakes, rice vinegar, gochujang, toasted sesame seeds, garlic, sesame oil, organic sugar
Korean Beef Stew (Galbi Jjim): beef short ribs, water, white onion, garlic, ginger, fine salt, beef stock, soy sauce, brown sugar, sesame oil, toasted sesame seeds, scallions
Korean Corn Dog: hot dogs, fresh mozzarella cheese, all-purpose flour, sugar, salt, baking powder, large egg, milk, panko, oil, mustard, ketchup
Korean Ground Beef Lettuce Wraps: lean ground beef, garlic cloves, sesame oil, chili powder, brown sugar, fresh ginger, soy sauce, green onions, cooked white rice, lettuce leaves
Korean-Style Steamed Eggs (Gyeran Jjim): large eggs, salt, water, scallion, toasted sesame seeds
Korean Beef & Broccoli: ground beef, brown sugar, canola oil, soy sauce, water, garlic, ginger, red pepper flakes, broccoli, cornstarch
Korean BBQ Pork Chops: low sodium soy sauce, brown sugar, minced garlic, rice wine vinegar, chili paste, minced ginger, sesame oil, water, cornstarch, boneless center cut pork chops, green onions
Spicy Korean Cucumber Salad (Oi Muchim): cucumbers, rice wine vinegar, sea salt, rice wine vinegar, red pepper, sugar, garlic, white sesame seeds, toasted sesame oil
Korean Beef and Cabbage: low sodium soy sauce, rice vinegar, sesame oil, green onions, ginger, brown sugar, cloves garlic, Sriracha, sirloin steak, cabbage
Korean Spicy Topokki: rice cakes, fish cakes, carrot, stock, gochujang, ketchup, cane sugar, mirin, salt, pepper, toasted sesame seeds, scallion
Korean Style Noodles: gochujang, mushrooms, spring onions, chives, red chili, ham, chicken stock, soy sauce, sesame oil, noodles, oil, salt
Galbi (Kalbi) Korean Marinated Rib BBQ: stock, soy sauce, brown sugar, mirin, rice wine, sesame oil, black pepper, garlic, green onions, kiwi, pineapple, beef short ribs
Korean Beef Stew: short ribs, vegetable oil, beef stock, soy sauce, rice wine, apple juice, gochujang, sesame oil, garlic, onion, salt, pepper, carrots, sweet potatoes
Spicy Korean Pork Stir Fry: garlic, ginger, rice wine, mirin, gochujang, pork loin, bok choy, red onion, white sesame seeds, green onions, cooking oil
Korean Beef Rice Bowls: low sodium soy sauce, light brown sugar, sesame oil, crushed red pepper flakes, cooking spray, lean ground beef, yellow onion, garlic cloves, ginger, cooked brown rice, sliced cucumber, gochujang, sesame seeds, scallions
Korean Chicken: boneless chicken breast, gochujang, gochugaru, vegetable oil, soy sauce, brown sugar, ginger, garlic, mixed vegetables, scallion
Korean Spinach, the Rustic Version: spinach, soybean paste, Korean chili paste, garlic clove, sesame oil, sesame seeds
Korean Style Chicken Wings: chicken wings, soy sauce, olive oil, garlic, honey, soya sauce, red pepper, sesame oil, red wine vinegar, garlic, black pepper, parsley
Korean Black Bean Noodles (Jajangmyeon): vegetable oil, pork belly, daikon, onions, zucchini, small potatoes, bean paste, water, korean noodles, sesame oil, seedless cucumber, pickled radish, onion
Korean Steamed Egg: chicken stock, large eggs, fish sauce, scallion
Korean Style Zucchini: zucchini, gochujang, water, seasoning
Spicy Korean Silken Soft Tofu Stew: anchovies, water, garlic, onions, kimchi, gochugaru, sesame oil, soy sauce, soft tofu, enoki mushrooms, egg, canola oil, green onions
Paleo Korean Beef Bowls: coconut aminos, honey, sesame oil, garlic cloves, fresh ginger, scallions, black pepper, chili paste, cooking oil, ground beef, toasted sesame seeds, rice, broccoli florets
Korean Pancake Recipe – Jeon: pancake batter, squash, scallions, all purpose flour, water, egg, salt, gochugaru, vegetable oil, sauce, light soy sauce, rice vinegar, toasted sesame oil, sesame oil
Korean Gochujang Sticky Boneless Beef Short Ribs: boneless beef short ribs, light soy sauce, sesame oil, rice vinegar, kosher salt, black pepper, red chili flakes, chili paste, honey, minced garlic, fresh ginger, green onions, white sesame seeds
Sukju Namul (Korean Bean Sprout Salad): bean sprouts, garlic clove, chives, toasted sesame seeds, light soy sauce, sesame oil, sugar
Vegan Korean Glazed Fried Chicken Tenders: soy sauce, gochujang, brown sugar, rice vinegar, ginger paste, garlic paste, seitan
Korean Pancake With Scallions (Pa Jun): flour, eggs, water, scallions, salt, oil
Korean Beef Barbecue Bulgogi: bulgogi, beef
Korean Shitake Mushrooms: dried shitake mushrooms, sesame seeds, minced garlic, oil, green onion, sesame oil, salt
Korean Bbq Sauce: low sodium soy sauce, water, light brown sugar, mirin, sesame oil, rice wine vinegar, black pepper, red pepper flakes, Sriracha sauce, ginger, garlic, scallion, cornstarch, water
KOREAN VEGETARIAN DUMPLINGS: soy sauce, vinegar, water, sugar syrup, gochugaru, firm tofu, fresh ginger, onion, shiitake mushrooms, carrots, zucchini, sweet potato vermicelli noodles, scallions, soy sauce, sesame oil, black pepper, sugar
Galbi - Korean Short Ribs: beef short ribs, pear, rice wine, soy sauce, sugar, sesame oil, onion, garlic, green onion, black pepper, sesame seeds, pine nuts
Vegan Korean Beef: seitan, white onion, red bell pepper, sesame seeds, garlic, scallions, orange juice, vegan chicken broth, soy sauce, vegan Worcestershire sauce, rice wine vinegar, chili paste, agave syrup, toasted sesame oil, smoked paprika, liquid smoke, salt, ground black pepper, cornstarch, cold water
Sweet and Sticky Korean Fried Chicken: vegetable oil, chicken wings, kosher salt, freshly ground black pepper, soy sauce, sugar
Mandu (Korean Dumplings): dumpling wrappers, kimchi, tofu, mung bean sprouts, onion, scallions, ground pork, minced garlic, ginger, sesame oil, soy sauce, egg, salt, pepper, soy sauce, vinegar, water, sugar, black pepper, red pepper flakes
Marinated Korean BBQ Beef: flank steak, soy sauce, oil, cloves garlic, brown sugar, rice wine vinegar, fresh ginger, chili garlic sauce
Korean Country Ribs: rice vinegar, large garlic cloves, chopped ginger, soy sauce, beef broth, brown sugar, gochujang, sesame oil, oil, salt, black pepper, rib eye, cornstarch, chives, toasted sesame seeds
Korean Marinated Beef: low sodium soy sauce, sugar, sesame oil, garlic cloves, minced ginger, green onions, sesame seeds, flank steak, vegetable oil
Korean Braised Tofu: tofu, water, red pepper flakes, brown sugar, vegetable oil, sesame oil, scallions, lime juice, sesame seeds, corn starch
Grilled Korean Ribs: ribs, ketchup, soy sauce, brown sugar, Franks Hot Sauce, water, garlic powder, onion powder, ground pepper
Easy Korean Beef: sesame oil, lean ground beef, soy sauce, brown sugar, ground ginger, red pepper flakes, scallions
Oven Baked Korean Fried Chicken: chicken wings, plain bread crumbs, panko, large eggs, soy sauce, kosher salt, black pepper, avocado oil, fresh ginger, garlic cloves, gochujang, honey, soy sauce, rice wine vinegar, sesame oil, black sesame seeds
Korean Fresh Kimchi: napa cabbage, cold water, coarse sea salt, garlic, green onions, red pepper flakes, gochugaru, fish sauce, apricot, toasted sesame seeds
Sigeumchi Namul (Korean Spinach): spinach, sea salt, spinach, sea salt, black pepper, sesame oil, toasted sesame seeds, garlic, green onion, spinach, gochujang, Korean red pepper paste, rice vinegar, black pepper, sesame oil, toasted sesame seeds, garlic, green onion
Easy Keto Korean Ground Beef Bowl: olive oil, cauliflower, sea salt, black pepper, olive oil, ground beef, sea salt, garlic, coconut aminos, beef broth, sesame oil, ground ginger, crushed red pepper flakes, green onions, sesame seeds, cucumber
Korean Salad Dressing: clove garlic, sesame seeds, stevia, soy sauce, rice vinegar, sesame oil, gochugaru
Korean BBQ Beef: sirloin steak, rice wine, low sodium soy sauce, brown sugar, minced garlic, Sriracha chili sauce, sesame oil
Grilled Korean Meatballs: lean ground beef, gochujang, minced garlic, soy sauce, sesame oil, brown sugar, toasted sesame seeds, rice wine, corn starch, scallion
Korean Hamburgers: ground beef, soy sauce, sugar, sesame seeds, vegetable oil, green onions, minced garlic, black pepper, hamburger buns, butter, lettuce
Korean Dipping Sauce: sesame seeds, firm tofu, gochujang, honey, sesame oil, doenjang, garlic, scallion
Korean-Style Steak and Noodles with Kimchi: reduced-sodium soy sauce, rice vinegar, packed brown sugar, toasted sesame oil, gochujang, flank steak, rice noodles, vegetable oil, shiitake mushrooms, carrots, green onions, fresh baby spinach, kimchi, toasted sesame seeds, Sriracha sauce
Korean Pancakes©: pancake mix, water, veggies, soy sauce, vinegar, cabbage, kimchi, chives, mung bean sprouts, green onions, match stick carrots
Korean Ramen Noodle Soup: ramen noodles, olive oil, gochugaru, dried shiitake mushrooms, dried kelp, water, garlic, small carrot, white button mushrooms, salt, white miso, gochujang, nutritional yeast, scallions
Korean Gochujang Wings: fresh ginger, gochujang, pomegranate molasses, honey, umeboshi plum vinegar, chicken wings, roasted salted cashews, toasted sesame seeds, paprika, salt, pepper
Spicy Korean Pork Rice Bowls: olive oil, red bell pepper, onion, large carrot, lean ground pork, soy sauce, Korean chili paste, honey, ginger paste, garlic paste, cooked rice, mayo, Korean chili paste, soy sauce
Korean Fried Chicken Wings: lemon, fresh ginger, honey, garlic, black peppercorns, fine sea salt, water, chicken wings, garlic, fresh ginger, soy sauce, gochujang, rice vinegar, sesame oil, honey, canola oil, all purpose flour, cornstarch, water
Korean Spicy Bibimbap Sauce: gochujang, sesame oil, brown sugar, soy sauce, water, rice vinegar, minced garlic, toasted sesame seeds
Korean Radish Soup (Muguk): radish, scallions, beef brisket, minced garlic, sesame oil, guk-ganjang, salt, pepper
Korean Kalbi Baby Back Ribs: baby back ribs, ground black pepper, salt, onions, garlic, fresh ginger, honey, brown sugar, soy sauce, sesame seeds, dark sesame oil, green onions, rice vinegar
Korean BBQ Grilled Wings: Tyson Grillin Wings, vegetable oil, fresh ginger, sherry, vinegar, sesame oil, honey, soy sauce, chili garlic sauce
Korean Chicken Meal Prep Bowls: boneless skinless chicken thighs, jasmine rice, coleslaw mix, low sodium soy sauce, rice vinegar, honey, sesame oil, ginger, low sodium soy sauce, honey, ginger, garlic, sesame oil, sesame seeds
Slow-braised Korean Short Ribs: beef short ribs, oil, spring onions, cloves, ginger, rice wine vinegar, lime, gochujang, soy sauce, soft brown sugar, sesame oil, sesame seeds, basmati rice, rice vinegar, sesame oil, golden caster sugar, red chilli, clove, cucumbers
Jap Chae Korean Glass Noodles: noodles, sesame oil, cooking oil, onions, carrots, garlic, green onions, fresh mushrooms, spinach, soy sauce, sugar, sesame seeds
Korean Style Cocktail Meatballs: ground turkey, low sodium soy sauce, ginger, sesame oil, fish sauce, garlic cloves, green onion, serrano chile, rice flour, egg white, pepper, salt, korean chile paste, light corn syrup, granulated sugar, rice wine vinegar, sesame oil, low sodium soy sauce, green onion, toasted sesame seeds
Korean Gochujang Marinated Chicken: chicken thighs, garlic, gochujang, soy sauce, fish sauce, salt, cracked black pepper, water, cooked rice, scallions
Korean Beef Bowl Meal Prep: brown rice, large eggs, olive oil, garlic, spinach, brown sugar, reduced sodium soy sauce, ginger, sesame oil, Sriracha, olive oil, garlic, ground beef, green onions, sesame seeds
Korean Spicy Pork Bulgogi: gochugaru, mirin, soy sauce, fish sauce, extract, sugar, black pepper, garlic, pork butt, large onion, cooking oil, green onions, green chili, sesame seeds, sesame oil
Korean Chilled Zucchini Sides: medium zucchini, fine sea salt, medium zucchini, minced garlic, scallions, toasted sesame oil, sesame seeds, avocado oil
Kalbi – Korean BBQ Flanken Short Ribs: flanken-cut short ribs, soy sauce, brown sugar, mirin, garlic cloves, Asian pear, yellow onion, sesame oil, water, fresh ginger, ground black pepper, kosher salt
Vegetarian Korean Dolsot Bibimbap: cucumber, salt, firm tofu, toasted sesame oil, carrot, soybean sprouts, spinach leaves, toasted sesame seeds, cooked rice, egg, seaweed, gochujang
Spicy Korean Kimchi Ramen: pork belly, garlic, ginger, soy sauce, sesame oil, medium onion, kimchi, gochujang, gochugaru, chicken broth, water, ramen noodles, eggs, scallions
Easy Spicy Korean Pork for Dummies: pork, onion, Korean chili paste, Korean chili flakes, soy sauce, sugar, garlic, fresh ginger, ginger powder, sesame oil, toasted sesame seeds, corn syrup, canola oil
Spicy Korean Chicken Stew, Dakdoritang: chicken, carrots, onion, potato, green chilies, green onion, stock, Korean chili paste, Korean chili flakes, soy sauce, soy sauce, oyster sauce, honey, garlic cloves, ginger, rice wine, sesame oil
Korean Chicken Wings: chicken wings, baking powder, brown sugar, ginger powder, salt, onion powder, low sodium soy sauce, water, gochujang, honey, brown sugar, butter, sesame oil, rice wine, cornstarch
Vegetarian Korean Bibimbap Bowls: daikon radish, carrot, salt, sugar, rice vinegar, warm water, House Foods Extra Firm Tofu, soy sauce, cornstarch, vegetable oil, cucumber, sesame oil, toasted sesame seeds, brown mushrooms, vegetable oil, baby spinach leaves, vegetable oil, minced garlic, sesame oil, toasted sesame seeds, scallion, gochujang, honey, sesame oil, water, rice vinegar, toasted sesame seeds, jasmine rice, fried eggs, bean sprouts
Korean Style Ribs: pork ribs, soy sauce, orange juice, rice vinegar, ginger, chili flakes, garlic, toasted sesame oil, honey, toasted sesame seeds, scallions, corn starch
Korean Spicy Soba Noodles: seedless cucumber, kimchi, soy sauce, toasted sesame oil, garlic cloves, rice wine vinegar, organic sugar, soba noodles, scallions, toasted sesame seeds
Marinated Korean BBQ Tofu: firm tofu, bbq sauce, garlic, sliced scallions, sesame
Korean Beef Skewers: flank steak, toasted sesame seeds, sesame oil, red wine vinegar, soy sauce, vegetable oil, brown sugar, garlic, green onions, freshly ground pepper, crushed red pepper flakes
Korean Shirt Ribs: soy sauce, brown sugar, water, garlic, rice vinegar, green onions, sesame oil, flanken, sliced green onions
Korean Cold Noodles: korean buckwheat noodles, broth, water, rice vinegar, soy sauce, honey, sesame oil, red pepper flakes, salt, hard boiled eggs, cucumber, asian pear, green onions, kimchi
Korean Fire Chicken (Chijeu-buldak): chicken breast, gochugaru, gochujang, soy sauce, vegetable oil, sesame oil, ground black pepper, honey, garlic, ginger, shredded mozzarella cheese, water, green onion
Impossible™ Korean Tacos: Impossible™ Burger, garlic, pear, shallot, sesame oil, savoy cabbage, carrot, green onions, tamari, sesame seeds, Sriracha, limes, avocado, Korean chili powder, mirin, ginger, gochujang, dark brown sugar, tortillas, daikon, cilantro, rice vinegar, dark sesame oil, tamari, plain yogurt, agave, salt, lime juice
15 Minute Korean Beef Bowl: ground beef, white onion, avocado oil, scallions, broccoli, kimchi, sesame seeds, steamed rice, brown sugar, low sodium soy sauce, dark soy sauce, sesame oil, garlic, ginger, red pepper flakes, gochujang
Spicy Korean Boneless Wings: boneless skinless chicken breasts, corn starch, green onion, butter, brown sugar, rice vinegar, red pepper flakes, low sodium soy sauce, fresh ginger, garlic clove, sesame oil, gochujang, oil
Spicy Korean-Style Chicken Wings: chicken wings, extra virgin olive oil, kosher salt, ground black pepper, garlic, ginger, sesame oil, gochujang, mirin, soy sauce, honey, scallions
Korean-Inspired Ground Turkey: low sodium soy sauce, packed brown sugar, cornstarch, ground ginger, crushed red pepper flakes, black pepper, sesame oil, ground turkey breast, small onion, garlic cloves, sesame seeds, scallions
Oven Fried Korean Chicken Tacos: garlic, fresh ginger, brown sugar, rice wine vinegar, tamari sauce, mirin, sesame oil, lime zest, toasted sesame seeds, broccoli slaw mix, carrots, jalapeno pepper, salt, black pepper, skinless chicken breasts, eggs, all purpose flour, baking soda, sea salt, black pepper, cayenne pepper, garlic, fresh ginger, korean chile paste, honey, tamari sauce, rice wine vinegar, sesame oil, fish sauce, corn tortillas, Cotija cheese, fresh cilantro, toasted sesame seeds
Korean Chicken Rice Bowl: soy sauce, lemon juice, honey, brown sugar, mirin, garlic, ginger, sesame oil, sesame seeds, gochujang, garlic, ginger, orange juice, lime juice, sweet chili sauce, gochujang, Sriracha, chicken thighs, green onions, spinach, eggs, cooked rice
Korean-Style Marinated Cucumbers: melissa, daikon, scallions, hot pepper paste, shrimp paste, fish sauce, garlic, fresh ginger, granulated sugar, sesame oil
Korean Carrot Salad: carrots, red onion, garlic, olive oil, vinegar, lemon, coriander seed, salt, sugar, cayenne, fresh cilantro
Bibimbab (Korean Rice and Vegetables): cooked rice, kochu chang, sugar, sesame oil, toasted sesame seeds
Korean Shrimp Ramen Noodle Stir Fry: soy sauce, toasted sesame oil, honey, gochujang, mirin, gochugaru, garlic, grated ginger, ramen noodles, vegetable oil, peeled and deveined shrimp, large carrots, cremini mushrooms, scallions, kimchi, bean sprouts, toasted sesame seeds
Vegetarian Spicy Korean Bibimbap Bowls: medium zucchini, shredded carrots, shredded red cabbage, mushrooms, sesame oil, udon noodles, coconut oil, eggs, Sriracha
Korean Beef Bowls Meal Prep: olive oil, flank steak, broccoli florets, cooked brown rice, scallions, white sesame seeds, low sodium soy sauce, brown sugar, rice wine, sesame oil, Sriracha, garlic cloves
Korean Vegetarian "Beef": veggie, brown sugar, light soy sauce, olive oil, sesame oil, onion, garlic, ground ginger, crushed red pepper flakes, ground black pepper, sesame seeds, cooked white rice, sliced green onions
Korean Japchae Glass Noodles Recipe - Super Foods Version!: glass noodles, sweet potato, kale, onion, green onion, garlic, soy sauce, brown sugar, sesame oil, roasted sesame seeds, cooking oil
Korean Beef Meal Prep Bowls: cooked brown rice, garlic, ginger, sesame oil, soy sauce, honey, onion, salt, ground turkey, cucumber, rice vinegar, honey, red pepper flakes, sesame seeds, green onion, sauce
Ultimate Korean Short Ribs: Asian pear, yellow onion, mirin, sake, tamari sauce, peeled fresh ginger, garlic, boneless short ribs
Korean Tofu Bibimbap Sandwiches: gochujang, sesame oil, agave, rice vinegar, water, garlic cloves, extra firm tofu, vegetable oil, shiitake, carrots, garlic cloves, baby spinach leaves, kimchi, scallion, toasted sesame seeds, sandwich rolls, vegan mayonnaise
Korean Gnocchi: sesame oil, hot Italian sausage, scallions, sesame seeds, shiitake mushrooms, tomato paste, Korean rice cakes, thai basil, white wine, gochujang, miso, pear, red onion
Homemade Korean Strawberry Milk: strawberries, sugar, strawberries, milk
Korean Barbecued Beef: beef tenderloin, garlic cloves, sugar, light soy sauce, dark soy sauce, sesame oil, rice vinegar, green onions, peeled fresh ginger, sesame seeds, ground black pepper, water, chili sauce, canola oil
Korean Boiled Bean Sprouts Salads: salad, bean sprouts, spring onion, garlic, chilli powder, light soy sauce, salt, sesame oil, salad, bean sprouts, spring onion, garlic, light soy sauce, salt
Korean BBQ Chicken Recipe for Wings: garlic cloves, fresh ginger root, soy sauce, rice wine vinegar, green onions, white sesame seeds, white granulated sugar, kiwis, ground black pepper, red pepper flakes, chicken wings
McCormick’s Korean BBQ Wings: pepper, soy sauce, honey, minced garlic, sesame oil, McCormick Ground Ginger, chicken wing, asian pear, green onions, sesame seed
Korean Spicy Pork Bulgogi (Dweji Bulgogi 돼지불고기 or Jeyeuk Bokkum 제육볶음): pork shoulder, chili pepper, minced garlic, ginger, soy sauce, sugar, pepper flakes, sake, toasted sesame oil, honey, toasted sesame seeds, onion, scallions
Korean Kalbi: beef short ribs, sake, pear juice, tamari, honey, garlic, sesame oil, sesame seeds, green onion, black pepper
Gochujang Korean Ribs: baby-back pork ribs, gochujang, dark brown sugar, soy sauce, rice vinegar, toasted sesame oil, mirin, garlic
Mapo Tofu (Korean-style): tofu, ground pork, medium onion, scallions, minced garlic, green bell pepper, red bell pepper, cooking oil, gochugaru, soy sauce, doenjang, gochujang, sugar, sesame oil, starch
Korean-Style Chicken Wings: chicken wings, large egg whites, baking soda, sea salt, soy sauce, apple juice, honey, rice vinegar, sesame oil, dried chillies, toasted sesame seeds, garlic clove, fresh ginger, shallot
Spicy Korean Cucumber Kimchi Refrigerator Pickles: kirby cucumbers, sea salt, Korean chili powder, ginger, garlic cloves, gluten free soy sauce, scallions, water
Korean Bulgogi Pork: pork tenderloin, garlic, fresh ginger, soy sauce, red chili flakes, pear, sesame oil, light brown sugar, vegetable oil, green onions
Bulgogi Recipe - Korean Barbecue Beef 불고기: rib-eye steak, rib eye steak, beef, soy sauce, white sugar, sesame oil, garlic, yellow onion, green onions, toasted sesame seeds, red pepper flakes, black pepper, ginger
Korean Bibimbap Bowls with Cauliflower Rice: cauliflower, sesame oil, carrots, zucchini, red pepper, bean sprouts, white mushrooms, fresh spinach, eggs, gochujang
Korean BBQ Ribs: short ribs, bbq sauce, pineapple
LA Galbi (Korean BBQ Short Ribs): beef short ribs, soy sauce, water, sugar, honey, rice wine, sesame oil, Asian pear, medium onion, scallions, minced garlic, minced ginger, black pepper, sesame seeds
Jap Chae (Korean Stir Fry Noodles - GF): beef, garlic cloves, granulated sugar, soy sauce, toasted sesame oil, olive oil, onion, carrots, dried shitake mushrooms, warm water, white mushrooms, baby spinach leaves, noodles, green onion, table salt, ground black pepper, toasted sesame seeds
Korean Oven Braised Short Ribs: beef short ribs, flour, kosher salt, pepper, green onions, garlic, fresh ginger, rice wine vinegar, limes, lime juice, gochujang, low sodium soy sauce, brown sugar, sesame oil, roast beef, water, chili pepper, green onions, chopped cilantro, sesame seeds, rice
Crispy Gochujang Korean Tofu: extra firm tofu, soy sauce, cornstarch, gluten free breadcrumbs, low sodium soy sauce, gochujang, tomato paste, vegetable broth, honey, toasted sesame oil, rice vinegar, minced garlic, fresh grated ginger, cornstarch, water
Spicy Korean Barbecue Chicken: chicken thigh fillet, gochujang, soy sauce, mirin, sake, sesame oil, red chili powder, sugar, minced garlic, ginger root, ground pepper
Korean BBQ Pork: pork shoulder, green onion, garlic, ginger, chili paste, red pepper flakes, soy sauce, rice vinegar, sesame oil, sugar, black pepper, canola oil, sesame seeds
Japchae - Korean Glass Noodles: canola oil, beef stew meat, large carrots, onion, spinach, glass noodles, wood ear mushrooms, soy sauce, sugar, sesame oil, rice wine, garlic powder, soy sauce, sugar, sesame oil
Yangnyeomjang - Korean Seasoning Sauce: soy sauce, toasted sesame oil, rice vinegar, gochugaru, toasted sesame seeds, sugar, garlic, scallion
Korean Spicy Pickled Cabbage (Baechu Kimchi): water, cabbages, coarse salt, chopped garlic, ginger, red pepper flakes, sugar, scallions, fish sauce
Soy-Grilled Mahi Mahi recipe with Korean Dipping Sauce: mahi mahi, soy sauce, rice vinegar, sesame oil, stevia, green onion, garlic puree, cayenne pepper, hot sauce
Korean Braised Tofu [Vegan]: onion, firm tofu, sugar, Korean chili powder, soy sauce, sake, scallion, toasted sesame seeds
Korean Spicy Stir-Fried Squid: squid, red chili pepper flakes, black pepper, salt, fish sauce, garlic cloves, green onions, soy sauce, sesame seed oil, sesame seeds, avocado oil
Korean Bbq Tofu Bowl: ketchup, rice vinegar, soy sauce, sugar, sesame seeds, Sriracha, garlic cloves, black pepper, green onions, ginger, sesame oil, sesame oil, broccoli florets, water, zucchini, pineapple, red pepper, soy sauce, tofu, quinoa, red cabbage, green onions, sesame seeds
Korean Style Tacos with Kogi BBQ Sauce: cooked pulled pork, corn tortillas, pickle, hot pepper paste, sugar, soy sauce, rice wine vinegar, sesame oil, English cucumber, rice vinegar, sugar, chili pepper, salt
Kyochon Korean Fried Chicken Wings: flour, cornstarch, water, chicken wings
Vegan Korean Nourish Bowl with Barley (Bibimbap): baby bok choy, zucchini, shredded carrots, chickpeas, cooked barley, kim chee, 1-2 tablespoons gochujang (see note), toasted sesame oil, brown sugar, water
Korean Vietnamese spring rolls: spring roll skins, rice, mung bean noodles, tofu, lettuce, soy sauce, vinegar, sugar, red onion, red chili, garlic, cilantro
Korean Noodles with Beef and Vegetables (Chap Chae): canola oil, julienned carrots, kosher salt, ground white pepper, onions, red bell pepper, button mushrooms, filet mignon, garlic, soy sauce, sugar, noodles, toasted sesame oil, sliced scallions, toasted sesame seeds
Korean BBQ Meatballs: turkey, onion, garlic, scallion, large egg, breadcrumbs, sesame seeds, cilantro, salt, pepper, oil, low sodium chicken stock, low sodium soy sauce, runny honey, cornstarch, sesame oil, sesame seeds, ground ginger, garlic powder, scallions
15 Minute Korean Style Beef: toasted sesame oil, lean ground beef, garlic, ginger, honey, low sodium soy sauce, pear juice, gochujang, cooked rice, green onions, toasted sesame seeds
Japchae (Korean glass noodle stir fry): beef fillet, sirloin, soy sauce, sesame oil, sugar, crushed garlic, potato starch noodles, spinach, carrot, onion, shitake mushrooms, bell pepper, vegetable oil, soy sauce, brown sugar, sesame oil
Korean Roasted Sweet Potatoes: korean chile paste, sesame seeds, olive oil, brown sugar, rice vinegar, sesame oil, soy sauce, garlic, sweet potatoes, onion, green onions, lettuce leaves
Korean-Style Spicy Wings: soy sauce, sesame oil, garlic powder, onion powder, ginger powder, salt, pepper, chicken wings, kochujang, red wine vinegar, brown sugar, salt, pepper
Buldak (Korean Spicy Chicken): chicken breast, pepper flakes, gochujang, soy sauce, sesame, Korean rice syrup, garlic, ginger, rice cake, salt, pepper, green onion
Korean Shredded Pork: boneless pork loin, hoisin sauce, low sodium soy sauce, rice vinegar, fresh ginger, garlic cloves, sliced green onions
Gluten Free Korean Turkey and Rice Bowl: lean ground turkey, brown sugar, gluten-free soy sauce, sesame oil, minced garlic, ground ginger, crushed red pepper flakes, fresh cilantro, cooked rice
Sweet and Spicy Korean-Style Cocktail Meatballs: ground pork, ground beef, gochujang, soy sauce, ginger, garlic cloves, scallion, sesame oil, honey, panko breadcrumbs, egg, kosher salt, pepper, gochujang, honey, ketchup, rice vinegar, toasted sesame oil, soy sauce, scallion, toasted sesame seeds
Bibimbap – Korean Rice Bowl: cube steaks, carrots, red bell peppers, portabella mushroom caps, zucchini, spinach, sprouts, garlic cloves, sugar, low sodium soy sauce, sesame oil, ketchup, Sriracha sauce, cooked white rice, eggs, toasted sesame seeds
Spicy Sweet & Tangy Korean Ribs with Korean BBQ Sauce: pork ribs, gochujang, soy sauce, hoisin sauce, sesame oil, rice wine vinegar, brown sugar, minced garlic, grated ginger, lime zest, lime juice, orange juice, marinade, green onion, cilantro, toasted sesame seeds, lime wedges
Spicy Korean Gochujang Chicken Wings: chicken wings, salt, ground black pepper, vegetable oil, garlic, ginger, sugar, rice vinegar, soy sauce, gochujang, toasted sesame seeds
Korean Fried Cauliflower: cauliflower, oil, cornstarch, all purpose flour, baking powder, ice water, vodka, toasted sesame seeds, scallions, garlic cloves, low sodium soy sauce, mirin, brown sugar, gochujang, cornstarch, water
Slow Cooker Korean BBQ Sauce: meat, soy sauce, brown sugar, minced garlic, rice wine vinegar, sesame oil, chili pepper and garlic sauce, fresh ginger, black pepper
Keto Korean BBQ Ribs: beef ribs, soy sauce, brown sugar, beef broth, unseasoned rice vinegar, sesame oil, ground ginger, pepper flakes, black pepper, garlic
Gangman Korean Tacos: pork belly, queso fresco, avocado, fresh chives, small onion, flour tortillas, garlic chili paste, olive oil, caster sugar, rice wine vinegar, gochujang, unsalted butter, minced garlic, black sesame seeds, white sesame seeds, sour cream, lime juice, garlic powder
Korean Barbeque Beef (Bulgogi): ribeye steak, teriyaki sauce, avocado oil, scallions, sesame seeds, crushed red pepper flakes
Instant Pot Korean Ground Beef – Bulgogi: vegetable oil, ground beef, garlic, soy sauce, water, brown sugar, sesame oil, ginger root, Asian pear, red pepper flakes, white pepper, jasmine rice, water, butter, tortillas, lettuce leaves, green onions, sesame seeds
Korean Chicken Stir Fry: chicken, salt, black pepper, garlic, fresh ginger, white onion, bell pepper, jalapeno peppers, green onion, hot pepper, white sesame seeds, soy sauce, rice wine vinegar, brown sugar, toasted sesame oil, cooked white rice, black sesame seeds
Korean Seasoned Dried Squid (Ojingeochae muchim) #SundaySupper: gochujang, honey, sesame oil, garlic powder, kosher salt, squid
Spicy Korean Fried Chicken: Korean chili flakes, garlic powder, salt, black pepper, boneless skinless chicken, flour, Korean chili flakes, black pepper, garlic powder, buttermilk, chili seasoning, sour cream, mayo, buttermilk, garlic, chili seasoning, salt, pepper
Korean Cubano: boneless pork shoulder, sesame oil, gochujang, honey, soy sauce, garlic, green onions, ginger, rice vinegar, sesame seeds, Cuban bread, mustard, swiss cheese, ham, kimchi, butter
Sweet & Tangy Korean-Style BBQ Pork Chops: garlic, dark brown sugar, honey, soy sauce, Worcestershire sauce, ketchup, Sriracha sauce, sesame oil, onion powder, ground ginger, cayenne pepper, crushed red pepper, boneless pork loin chops
Crunchy Korean Fried Chicken: chicken wings, salt, ground black pepper, minced ginger, potato starch, peanuts, garlic, dried red chili peppers, soy sauce, rice syrup, white vinegar, mustard, brown sugar, sesame seeds, grapeseed oil
Cold Korean Buckwheat Noodles: rice vinegar, red pepper, paprika, sugar, kosher salt, daikon, buckwheat noodles, toasted sesame oil, garlic, scallions, English cucumbers, toasted sesame seeds, nori, stock
Dubu Jorim (Korean Braised Tofu): firm tofu, vegetable, soy sauce, water, sesame oil, sugar, gochugaru, sesame seed, garlic, scallions
20-Minute Korean Beef Lettuce Wraps w/ Rainbow Veggie Slaw: sauce, soy sauce, brown sugar, chili paste, minced garlic, limes, honey, ground ginger, worcestershire sauce, beef, veggies, bell peppers, red onion, sesame oil, beef, salt, butter lettuce, cooking spray, scallions, sesame seeds
Beef Doenjang Jjigae, Korean Soy Bean Paste Stew With Beef: water, soybean paste, Korean chili paste, beef, onion, potato, shitake mushroom, zucchini, garlic, Korean chili flakes, green chili, green onion
Korean Grilled Stuffed Squid: oil, ground beef, salt, gochujang, sugar, red rice, squid, gochujang, oil, green onions
Vegan Jajangmyeon (Korean noodles with black bean sauce): udon noodles, vegetable oil, medium onion, button mushrooms, zucchini, celery stalks, cabbage, cucumber, black bean paste, rice vinegar, brown sugar, water, potato starch, salt, pepper
Korean BBQ Chicken Thighs: bone in chicken thighs, olive oil, garlic, powdered garlic, soy sauce, red pepper flakes, brown sugar, honey, sesame oil, rice wine vinegar, green onions, sesame seeds
Korean-Inspired Crispy Tofu Tacos: extra firm tofu, purple cabbage, green cabbage, shredded carrots, limes, kosher salt, freshly ground black pepper, mini cucumbers, granulated sugar, rice wine vinegar, red pepper flakes, cornstarch, canola oil, peeled fresh ginger, minced garlic, gochujang, light brown sugar, soy sauce, toasted sesame seeds, flour tortillas
Korean Spinach Salad: rice vinegar, soy sauce, stevia, gochugaru, sesame oil, sesame seeds, garlic, baby spinach, cherry tomatoes
Jjajangmyun, the Korean-chinese Noodles With Black Bean Paste: bean paste, seed, sugar, pork, cabbage, onion, zucchini, russet potato, oyster sauce, water, corn starch, salt, cucumber
Oven Roasted Korean Pork Belly With Onion Salad: pork belly, soy bean paste, honey, garlic powder, ginger powder, canola oil, yellow onion, red onion, Korean chili flakes, sugar, soy sauce, cider vinegar, sesame oil, toasted sesame seeds, ground black pepper
Roy's Grilled Korean Beef Short-Ribs: beef, soy sauce, pear juice, coke, rice wine, shallot, large garlic cloves, ginger, brown sugar, dark sesame oil, green onions, crushed red pepper, black pepper
Steak and Eggs Korean Style: mirin, Granny Smith apple, soy sauce, light corn syrup, finely chopped green onion, Korean hot pepper paste, peeled fresh ginger, garlic cloves, sesame oil, unseasoned rice vinegar, skirt steak, rice, water, sushi rice, salt, canola oil, kimchi, unseasoned rice vinegar, large eggs, green onions
Bulgogi, Korean Barbequed Beef: soy sauce, sesame oil, white wine, sugar, honey, garlic, ground black pepper, juice, asian pear, onion, beef
KOREAN WINTER STEWS [RECIPE]: gochujang, fresh squeezed lemon juice, soy sauce, water, pork shoulder, anchovies, dried kelp, dried shiitake mushrooms, water, gochujang, red pepper flakes, minced garlic, soy sauce, water, salt, chicken stock, green onion, kimchi, coriander, tofu, onion, cabbage
Spicy Korean Pork Stir-fry: pork fillets, vegetable oil, garlic cloves, onion, shredded carrot, spring onions, sesame seeds, lemon, steamed rice, gochujang, soy sauce, white sugar, grated ginger, sesame oil
Korean Style Quick Pickles: English cucumber, gochujang, mirin, garlic, sugar, dark sesame oil, salt
Korean Beef and Veggies: ground beef, veggies, brown sugar, soy sauce, red pepper flakes, garlic powder
15 Minute Korean Style Udon Stir Fry: boneless, skinless chicken thighs, udon noodles, soy sauce, bacon, sesame oil, garlic cloves, mirin, green onions, fried eggs, soy bean paste, kimchi, unsalted butter
Korean Fried Chicken Tacos with Sweet Slaw, Crunchy Noodles + Queso Fresco.: garlic, fresh ginger, soy sauce, gochujang, rice vinegar, sesame oil, honey, flour, cornstarch, chicken breast, chow mein noodles, green cabbage, carrots, red chiles, garlic, fresh ginger, soy sauce, honey, rice vinegar, sesame oil, lime, sesame seeds, black pepper, corn tortillas, queso fresco, fresh cilantro, sesame seeds, ginger
Korean Beef Bowl (Paleo + Whole30): shallot, fresh ginger, toasted sesame oil, ground beef, red pepper flakes, garlic powder, onion powder, salt, coconut aminos, fish sauce, cauliflower rice, greens, mayo, hot sauce
KOREAN CUCUMBER SALAD: cucumbers, green onions, yellow onion, yellow onion, toasted sesame oil, toasted sesame seeds, sea salt
KOREAN BBQ SHORT RIBS (GALBI): short ribs, bones, coconut aminos, water, apple cider vinegar, sesame oil, garlic cloves, ginger, maple syrup, black pepper, green onion
Crispy Korean Chicken Thighs: chicken thighs, soy sauce, sesame oil, black pepper, sugar, ginger, garlic cloves, scallion
Recipe for Spicy Korean Pork Marinade: onion, minced garlic, sesame oil, soy sauce, red pepper, sugar, rice wine, minced ginger
Korean Beef & Green Beans: ground beef, small onion, green beans, garlic, honey, soy sauce, ground ginger, crushed red pepper
Vegan Bulgogi (Korean BBQ Beef): crumbles, small onion, low sodium soy sauce, packed brown sugar, agave, toasted sesame oil, large garlic cloves, ground ginger, red chili flakes, ground black pepper, sesame seeds, brown rice, green onions
Korean Style Hamburger Patties: ground beef, finely chopped onion, green onion, garlic, water chestnuts, soy sauce, sesame oil, sugar, egg
Korean Braised Chicken Thighs: garlic, minced ginger, chicken broth, soy sauce, gochujang, mirin, sesame oil, canola oil, chicken thighs, salt, freshly ground black pepper, medium onion, cornstarch, sesame seeds, scallion
Korean Pulled Jackfruit Sandwiches: jackfruit, soy sauce, hoisin sauce, ketchup, rice vinegar, brown rice syrup, garlic, ginger, sesame oil, star anise, bbq sauce, Asian slaw, crusty buns, canola oil, onion, garlic, ginger, tomato paste, tomato puree, brown rice syrup, molasses, gochujang, hoisin sauce, kosher salt, liquid smoke, rice wine vinegar, mirin, sesame oil, ponzu sauce, kosher salt, nappa cabbage, carrot, asian pear, sesame seeds
Spicy Korean Chicken Meal Prep: chicken thighs, gochujang, Korean chili powder, paprika, soy sauce, maple syrup, garlic
Korean Bbq Bowls With Garlic Scented Rice: sirloin steak, asian pear, garlic, ginger, onion, soy sauce, sesame oil, scallion, oil, oil, garlic, parboiled rice, chicken broth, sesame seeds, red pepper flakes, rice vinegar, honey, sliced cucumbers, boiled eggs
Korean Rice Cakes (Dok Boki): rice cake, chili pepper, light soy sauce, sugar, rice vinegar, roasted sesame seeds
Korean Donut Twists: white sugar, muscovado sugar, cinnamon, roasted peanuts, butter, milk, sugar, salt, large egg, instant dry yeast, all purpose flour, canola oil
How to Cook Korean Ramen Hack: cold water, shiitake mushrooms, ramen noodles, eggs, green onions
Korean Pork Tacos: pork loin, brown sugar, soy sauce, garlic, seasoned rice wine vinegar, fresh ginger, jalapeno, sesame oil
Korean Braised Beef Short Ribs: medium onion, garlic, minced ginger, beef broth, soy sauce, brown sugar, unseasoned rice vinegar, gochujang, sesame oil, canola, salt, black pepper, bone-in beef short ribs, cornstarch, scallions, toasted sesame seeds, kimchi, shredded carrots, cooked brown rice
Dakkochi, Korean Chicken on a Stick: boneless skinless chicken breast, salt, black pepper, cooking wine, ginger, garlic, green onions, soy sauce, honey, sauce, gochugaru, Sriracha, black pepper, bamboo
Quick Korean pickles: cucumbers, garlic clove, rice vinegar, sugar, salt, sesame oil, toasted sesame seeds, gochugaru
Korean Style Mini Sweet Rice Cakes: sweet rice flour, rice flour, boiling water
Spicy Korean Cucumber Salad: cucumbers, kosher salt, large shallot, scallions, sesame seeds, toasted, gochujang, gochugaru, toasted sesame oil, soy sauce, rice vinegar, agave nectar, garlic cloves
Korean Spicy Tofu: tofu, garlic, gochujang, gochugaru, rice vinegar, sugar, water, sesame oil, corn flour, sesame seeds, spring onions, sunflower oil
Spicy Korean Style Cauliflower Wings: cauliflower, avocado, sauce, sesame oil, coconut aminos, maple syrup, sea salt, chili garlic sauce, water, butter lettuce, garlic cloves, fresh cilantro, sesame seeds, shredded carrots
Korean BBQ Chicken (Paleo + Whole30): chicken thighs, shallot, fresh ginger, coconut aminos, fish sauce, toasted sesame oil, white vinegar, tomato paste, red pepper flakes, garlic powder, green onion, sesame seeds
Kalbi - Korean Short Ribs Blender Marinade: short ribs, onion, water, soy sauce, red wine, sugar, large garlic cloves, green onions, sesame oil, sesame seeds, black pepper, syrup
Korean Meatloaf with Korean BBQ Glaze: lean ground beef, panko bread crumbs, gochujang, soy sauce, sesame seeds, garlic, ground ginger, sesame oil, egg, sesame oil, cornstarch, soy sauce, rice vinegar, brown sugar, garlic, ground ginger, sesame seeds
Chicken and Vegetable Korean Stir Fry: coconut oil, carrot, broccoli, yellow onion, red bell pepper, garlic, snow peas, boneless skinless chicken breasts, saffron, sea salt
Korean Zucchini Noodles: soy sauce, honey, sesame oil, lean beef, onion, egg, medium zucchini, medium carrot, green onion, garlic cloves, fresh mushrooms, baby spinach, sesame seeds, cooking oil
KOREAN BARBECUE RIBS: soy sauce, dark brown sugar, minced garlic, rice wine vinegar, Sriracha, fresh ginger, sesame oil, ground black pepper, sweet chile sauce, water, cornstarch, pork spare ribs, salt, pepper
Crockpot Korean Beef Tacos with Cucumber Slaw: beef short ribs, low sodium soy sauce, packed brown sugar, garlic, ginger, rice vinegar, dark sesame oil, vegetable oil, Sriracha, water, cucumber, red onion, salt, rice vinegar, crushed red pepper flakes, wheat tortillas, cilantro, bean sprouts, Greek yogurt, Sriracha
Korean Steak Bowls with Sesame Cucumber Slaw: flank steak, fine sea salt, freshly cracked black pepper, avocado oil, low-sodium soy sauce, coleslaw, English cucumber, chopped fresh cilantro, thinly sliced green onions, rice vinegar, low sodium soy sauce, maple syrup, toasted sesame oil, toasted sesame seeds, plain Greek yogurt, gochujang, brown rice
Korean Meatballs: ground beef, ground pork, egg, bread crumbs, milk, salt, pepper, gochujang, sugar, soy sauce, rice wine, rice vinegar, sesame oil, garlic cloves, grated ginger
Sweet and Spicy Korean Chicken Wings: chicken wings, baking powder, kosher salt, gochujang, dark brown sugar, soy sauce, rice wine, minced garlic, fresh ginger, toasted sesame oil
BBQ Korean Flanken Ribs: flanken, green onion, garlic, dark brown sugar, rice vinegar, soy sauce, sesame oil, black pepper
Korean Potato Salad: Yukon Gold potatoes, English cucumber, chopped onion, carrot, ham, hard boiled eggs, mayonnaise, sugar, rice vinegar, pepper, salt
Grain Free Korean Japchae: boneless, skinless chicken breasts, olive oil, salt, black pepper, baby carrots, mixed bell peppers, onion, minced garlic, kelp noodles, coconut aminos, fish sauce, sesame oil, frozen chopped spinach
All-purpose Korean Marinade: water, soy sauce, sugar, corn syrup, onion, apple, scallions, garlic cloves, ginger, dried shiitake mushrooms, peppercorns, dashima, rice wine, lemon
Korean Potato Side Dish - Gamja Jorim: baby potatoes, water, low sodium soy sauce, sugar, dark soy sauce, garlic, sesame oil, sesame seeds
Rustic Korean Spinach: fresh spinach, gochujang, doenjang, sesame oil, sesame seeds, garlic
Korean Chicken Bao Bun: all-purpose flour, corn flour, sugar, instant yeast, baking powder, salt, warm water, oil, popcorn, garlic paste, brown sugar, soya sauce, honey, garlic, ginger, vegetable oil, salt, cabbage, onion, chilli mayonnaise, garlic paste, coriander leaves, white sesame seeds
Korean Galbi | Korean Short Ribs: beef short ribs, agave nectar, soy sauce, water, mirin, onion, garlic, dark sesame oil, ground black pepper, scallions
Sweet & Spicy Korean Pork Belly Udon Soup: garlic cloves, fresh ginger, chili paste, honey, soy sauce, toasted sesame oil, pork belly, pork belly, onion, chili paste, honey, chicken broth, coconut milk, lime, salt, pepper, fresh udon noodles, kimchi, eggs, fresh cilantro, scallions, lime wedges
Korean Chicken Feet (Dakbal): chicken feet, coarse sea salt, Soju, garlic, ginger, Thai chili, gochujang, gochugaru, soy sauce, mirin, oyster sauce, sugar, black pepper, sesame oil, sesame seeds, green onion
Easy Korean Ground Beef: lean ground beef, garlic, minced ginger, green onions, sesame seeds, unsweetened apple sauce, low sodium soy sauce, brown sugar, rice wine vinegar, sesame oil, Sriracha, cornstarch, cucumber, shredded carrot, red onion, rice wine vinegar, water, honey, salt
Pan Fried Korean Pork Chop: soy sauce, honey, sesame oil, sweet chili sauce, garlic powder, ground ginger, boneless pork chops, sesame oil
Instant Pot Spicy Galbijjim (Korean Braised Short Ribs): beef short ribs, radish, medium carrot, dried shiitake mushrooms, Asian pear, medium onion, garlic cloves, ginger piece, soy sauce, rice wine, gochugaru, gochujang, honey, pepper, sesame oil, scallions, sesame seeds
Korean Dolsot Bibimbap (Stone Pot Bibimbap): garlic, Fuji Apple, onion, soy sauce, gochujang, lemon juice, mirin, sugar, sesame oil, black pepper, beef, soy sauce, mirin, rice wine, sesame oil, sugar, black pepper, sesame oil, salt, zucchini, yellow squash, carrots, shiitake mushrooms, mung bean sprouts, spinach, radish, kimchi, cooked rice, eggs, toasted sesame seeds
Korean Spicy Chicken Stew: oil, chicken, onion, potatoes, baby carrots, scallions, Korean chili paste, water, Korean chili powder, rice wine, soy sauce, sauce
Korean Spicy Garlic Eggplant: eggplant, garlic, green onions, soy sauce, agave nectar, sesame oil, gochugaru, sesame seeds, black pepper
Korean Kalbi Ribs: beef, ribs, rice wine, brown sugar, honey, chicken bouillon, pear juice, water, minced garlic, onion, red pepper flakes
Korean Beef Tacos (Bulgogi): sesame oil, garlic cloves, fresh grated ginger, soy sauce, light brown sugar, ground black pepper, hot water, flank steak, flour tortillas, purple cabbage, cilantro leaves, avocado, sour cream, mayonnaise, garlic powder, Sriracha hot sauce, fresh lime juice
Korean Pancakes with Spicy Dipping Sauce: chili peppers, onion flakes, sea salt, soy sauce, sugar, rice vinegar, water, sesame oil, garlic, flour, cornstarch, sugar, sparkling water, egg, scallions, small carrots, vegetable oil
Sweet and Spicy Korean Meatballs: lean ground beef, green onions, panko breadcrumbs, garlic, egg, Sriracha sauce, ground ginger, salt, pepper, apricot jam, soy sauce, Sriracha sauce
Instant Pot Korean BBQ Country-Style Ribs: country style pork ribs, kosher salt, seasoning, oil, bbq sauce, long grain rice, water, green onion, country style pork ribs, kosher salt, seasoning, oil, bbq sauce, green onion, long grain rice, water
Korean Ground Beef Stir Fry: lean ground beef, garlic cloves, olive oil, red bell pepper, zucchini, sugar snap peas, shredded carrots, mushrooms, brown sugar, reduced sodium soy sauce, sesame oil, ground ginger, crushed red pepper flakes, pepper, sliced green onions, sesame seeds
Korean Chive Salad: chive, gochugaru, red pepper flakes, sugar, sesame oil, sesame seeds, white vinegar, salt
7- Vegetable Korean Stir Fry: coconut oil, yellow onion, turnip, baby bok choy, red bell pepper, broccoli, zucchini squash, yellow squash, saffron, sea salt, basmati rice
Korean Beef Zucchini Noodles: brown sugar, reduced sodium soy sauce, ginger, sesame oil, sriracha, olive oil, garlic, ground beef, zucchini, green onions, sesame seeds
Crockpot Korean Tacos: pork shoulder, black pepper, coarse sea salt, onion, hoisin sauce, honey, soy sauce, water, mirin, sesame oil, lemongrass, rice wine, ginger powder, garlic powder, Chinese five-spice powder, mayonnaise, rice vinegar, broccoli slaw, pickled radishes, English cucumber, chopped cilantro, red bell pepper, corn tortillas, sriracha mayo
Instant Pot Korean Baby Back Ribs: baby back ribs, gochujang, soy sauce, brown sugar, mirin, garlic cloves, ginger paste, sesame oil, rice vinegar
Delicious Korean Beef Bulgogi (Korean BBQ): sirloin, onion, sesame oil, soy sauce, brown sugar, sesame oil, gochujang, rice wine, small onion, garlic cloves, ginger, pear, steamed white rice, kimchi, sesame seeds, lettuce
Korean Style Beef Tips: beef, vegetable oil, small onion, green onions, sesame seed, marinade, small onion, garlic, apple, brown sugar, dark sesame oil, soy sauce, pepper
[Holly’s Korean Kitchen] Easy Korean japchae: glass noodles, beef sirloin, oil, medium onion, medium carrot, small red bell pepper, salt, shiitake mushrooms, spinach, sesame oil, toasted sesame seeds, soy sauce, sugar, sweet rice wine, soy sauce, water, sugar, sweet rice wine, oil, minced garlic, black pepper
Slow Cooker Korean BBQ Beef: beef broth, reduced sodium soy sauce, brown sugar, garlic, sesame oil, rice wine vinegar, ginger, Sriracha sauce, onion powder, white pepper, boneless beef chuck, cornstarch, water, green onions, sesame seeds
Korean Galbi Bowls: soy sauce, water, pineapple juice, garlic, dark brown sugar, sesame oil, Chinese five-spice powder, boneless beef short ribs, fried egg, kimchi, Sriracha sauce, brown rice
Korean Gochujang Chicken Wings (baked/air Fried): chicken wings, baking powder, garlic powder, freshly cracked black pepper, Kashmiri red chili powder, kosher salt, avocado oil, garlic cloves, ginger root, green onions, gochujang, rice vinegar, rice syrup, water, Kashmiri red chili powder, kosher salt, toasted sesame oil, cilantro leaves, sesame seeds, lime
Korean Style Kalbi | Korean Style Ribs: short ribs, gochujang, soy sauce, agave nectar, garlic, minced ginger, sesame oil, mirin, splenda, kosher salt, ground black pepper, cornstarch, water
Grilled Korean Cauliflower: gochujang, dark brown sugar, mirin, soy sauce, minced garlic, freshly minced ginger, cauliflower, vegetable oil, kosher salt, toasted sesame seeds, scallions
Korean Sesame Tapioca Bread: egg, milk, bread mix
Korean Curry: olive oil, beef, potatoes, carrots, onions, curry sauce mix
Slow Cooker Sticky Korean Ribs: baby back ribs, brown sugar, paprika, chili powder, garlic powder, ground ginger, ground black pepper, salt, fresh ginger, ground black pepper, onion powder, garlic, sweet chili sauce, balsamic vinegar, rice wine vinegar, low sodium soy sauce, honey, Korean chili paste, cornstarch, water
Korean Turkey Meal Prep Bowls: olive oil, rice, broccoli, lean ground turkey, garlic, ginger, honey, soy sauce, sesame oil, red pepper flakes, pepper, green onions
Spicy Korean Baked Chicken Wings: chicken wings, canola oil, low sodium soy sauce, honey, Korean chili flakes, garlic powder, sesame seeds
Bibimbap (Korean Rice Bowl With Ground Beef and Veggies): rice, ground beef, soy sauce, garlic, sesame oil, sugar, ground black pepper, cucumbers, sugar, water, rice vinegar, salt, mushrooms, vegetable oil, garlic, mirin, tamari soy sauce, sesame oil, bean sprouts, rice vinegar, salt, red chile pepper, garlic, kosher salt, brown sugar, sesame oil, egg, jicama, shredded carrots, kimchi, gochujang
Korean Fried Beef: back ribs, chuck short ribs, chuck short ribs, ice water, cornstarch, all purpose flour, kosher salt, pepper, white sesame seeds, water, soy sauce, sugar, mirin, sesame oil, garlic cloves, chili sauce, honey, sesame oil, soy sauce, lemon, minced garlic, fresh minced ginger
Hotteok (Korean Sweet Pancakes): lukewarm water, sugar, active dry yeast, vegetable oil, salt, all purpose flour, brown sugar, chopped walnuts, cinnamon
Korean Army Stew: spam, pork and beans, kielbasa sausage, ground pork, firm tofu, kimchi, onion, mushroom, chicken stock, ramen noodle, ramen noodle seasoning, Korean chili flakes, Korean chili paste, minced garlic, soy sauce, black pepper
Korean Radish Side Dish: radish, green onion, garlic, gochugaru, fish sauce, sesame seeds, radish, green onion, garlic, gochugaru, fish sauce, sesame seeds
Korean-Southern Ribs: St. Louis cut spare ribs, gochujang, rub, bbq sauce, white sugar, brown sugar, smoked paprika, granulated garlic, granulated onion, red pepper flakes, coarsely ground black pepper, kosher salt, brown sugar, white sugar, soy sauce, sesame oil, sprite, gochujang
Korean Bean Sprouts (Kong Namul): soybean sprouts, scallion, garlic, sesame oil, roasted sesame seeds, kosher salt
Korean Style Steak: granulated sugar, soy sauce, oil, toasted sesame oil, peeled fresh ginger, garlic, shallots, kosher salt, freshly ground black pepper, hanger steak, scallions, toasted sesame seeds
